1111111111111
10010000100C1
1001000010111
10010C0010001
1001000C10001
1001000000001
1000011111001
1P0011E000001
1111111111111