1111111
1P00001
1000001
1000001
1110111
100C00E
1000000
1111111