1111111111
1P00000E01
1111010001
1000010001
1011110001
100C0000E1
1010111111
1010000001
1011111111
1111111111