111111111111
1P0000000001
101111101111
101C00001E01
101110111001
100010000001
111110111001
100001000001
101111101111
101000000001
101111111111
111111111111